2 2 2 2 2 2 2 2 2 2 2 2 2 2 2 2 2 
2 0 0 0 0 0 0 0 0 0 0 0 0 0 0 0 2 
2 0 0 0 0 0 0 0 0 0 0 0 0 0 2 0 2 
2 0 0 0 0 0 0 0 0 0 0 0 0 2 0 0 2 
2 0 0 0 0 0 0 0 0 0 0 0 2 0 0 0 2 
2 0 0 0 0 0 0 0 0 0 0 2 0 0 0 0 2 
2 0 0 0 0 0 0 0 0 0 2 0 0 0 0 0 2 
2 0 0 0 0 0 0 0 0 2 0 0 0 0 0 0 2 
2 0 0 0 0 0 0 0 2 0 0 0 0 0 0 0 2 
2 0 0 0 0 0 0 2 0 0 0 0 0 0 0 0 2 
2 0 0 0 0 0 2 0 0 0 0 0 0 0 0 0 2 
2 0 0 0 0 2 0 0 0 0 0 0 0 0 0 0 2 
2 0 0 0 2 0 0 0 0 0 0 0 0 0 0 0 2 
2 0 0 2 0 0 0 0 0 0 0 0 0 0 0 0 2 
2 0 2 0 0 0 0 0 0 0 0 0 0 0 0 0 2 
2 0 0 0 0 0 0 0 0 0 0 0 0 0 0 0 2 
2 2 2 2 2 2 2 2 2 2 2 2 2 2 2 2 2 
1 298 351 1 666 759 