2 2 2 2 2 2 2 2 2 2 2 2 2 2 2 2 2 
2 0 0 0 0 0 0 0 0 0 0 0 0 0 0 0 2 
2 0 0 0 0 0 0 0 0 0 0 0 0 0 0 0 2 
2 0 0 0 0 0 0 0 0 0 0 0 0 0 0 0 2 
2 0 0 0 2 2 2 2 0 2 2 2 2 0 0 0 2 
2 0 0 0 2 0 0 0 0 0 0 0 2 0 0 0 2 
2 0 0 0 2 0 0 0 0 0 0 0 2 0 0 0 2 
2 0 0 0 2 0 0 0 0 0 0 0 2 0 0 0 2 
2 0 0 0 0 0 0 0 0 0 0 0 0 0 0 0 2 
2 0 0 0 2 0 0 0 0 0 0 0 2 0 0 0 2 
2 0 0 0 2 0 0 0 0 0 0 0 2 0 0 0 2 
2 0 0 0 2 0 0 0 0 0 0 0 2 0 0 0 2 
2 0 0 0 2 2 2 2 0 2 2 2 2 0 0 0 2 
2 0 0 0 0 0 0 0 0 0 0 0 0 0 0 0 2 
2 0 0 0 0 0 0 0 0 0 0 0 0 0 0 0 2 
2 0 0 0 0 0 0 0 0 0 0 0 0 0 0 0 2 
2 2 2 2 2 2 2 2 2 2 2 2 2 2 2 2 2 
0 348 383 0 684 383 0 678 705 0 338 715 