3 3 3 3 3 3 3 3 3 3 3 3 3 3 3 3 3 
3 0 0 0 0 0 0 0 0 0 0 0 0 0 0 0 3 
3 0 0 0 0 0 0 0 0 0 0 0 0 0 0 0 3 
3 0 0 0 0 0 0 0 0 0 0 0 0 0 0 0 3 
3 0 0 0 3 3 3 3 0 3 3 3 3 0 0 0 3 
3 0 0 0 3 0 0 0 0 0 0 0 3 0 0 0 3 
3 0 0 0 3 0 0 0 0 0 0 0 3 0 0 0 3 
3 0 0 0 3 0 0 0 0 0 0 0 3 0 0 0 3 
3 0 0 0 0 0 0 0 0 0 0 0 0 0 0 0 3 
3 0 0 0 3 0 0 0 0 0 0 0 3 0 0 0 3 
3 0 0 0 3 0 0 0 0 0 0 0 3 0 0 0 3 
3 0 0 0 3 0 0 0 0 0 0 0 3 0 0 0 3 
3 0 0 0 3 3 3 3 0 3 3 3 3 0 0 0 3 
3 0 0 0 0 0 0 0 0 0 0 0 0 0 0 0 3 
3 0 0 0 0 0 0 0 0 0 0 0 0 0 0 0 3 
3 0 0 0 0 0 0 0 0 0 0 0 0 0 0 0 3 
3 3 3 3 3 3 3 3 3 3 3 3 3 3 3 3 3 
0 326 352 0 686 726 0 884 916 0 134 155 0 338 722 0 668 377 