2 2 2 2 2 2 2 2 2 2 2 2 2 2 2 2 2 
2 0 0 0 0 0 0 0 0 0 0 0 0 0 0 0 2 
2 0 0 0 0 0 0 0 2 0 0 0 0 0 0 0 2 
2 0 0 0 0 0 0 0 2 0 0 0 0 0 0 0 2 
2 0 0 0 0 0 0 0 2 0 0 0 0 0 0 0 2 
2 0 0 0 0 0 0 0 2 0 0 0 0 0 0 0 2 
2 0 0 0 0 0 0 0 2 0 0 0 0 0 0 0 2 
2 0 0 0 0 0 0 0 2 0 0 0 0 0 0 0 2 
2 0 2 2 2 2 2 2 2 2 2 2 2 2 2 0 2 
2 0 0 0 0 0 0 0 2 0 0 0 0 0 0 0 2 
2 0 0 0 0 0 0 0 2 0 0 0 0 0 0 0 2 
2 0 0 0 0 0 0 0 2 0 0 0 0 0 0 0 2 
2 0 0 0 0 0 0 0 2 0 0 0 0 0 0 0 2 
2 0 0 0 0 0 0 0 2 0 0 0 0 0 0 0 2 
2 0 0 0 0 0 0 0 2 0 0 0 0 0 0 0 2 
2 0 0 0 0 0 0 0 0 0 0 0 0 0 0 0 2 
2 2 2 2 2 2 2 2 2 2 2 2 2 2 2 2 2 
0 262 292 0 770 818 0 288 804 0 744 316 