3 3 3 3 3 3 3 3 3 3 3 3 3 3 3 3 3 
3 0 0 0 0 0 0 0 0 0 0 0 0 0 0 0 3 
3 0 3 0 3 0 3 0 3 0 3 0 3 0 3 0 3 
3 0 0 0 0 0 0 0 0 0 0 0 0 0 0 0 3 
3 0 3 0 3 0 3 0 3 0 3 0 3 0 3 0 3 
3 0 0 0 0 0 0 0 0 0 0 0 0 0 0 0 3 
3 0 3 0 3 0 3 0 3 0 3 0 3 0 3 0 3 
3 0 0 0 0 0 0 0 0 0 0 0 0 0 0 0 3 
3 0 3 0 3 0 3 0 3 0 3 0 3 0 3 0 3 
3 0 0 0 0 0 0 0 0 0 0 0 0 0 0 0 3 
3 0 3 0 3 0 3 0 3 0 3 0 3 0 3 0 3 
3 0 0 0 0 0 0 0 0 0 0 0 0 0 0 0 3 
3 0 3 0 3 0 3 0 3 0 3 0 3 0 3 0 3 
3 0 0 0 0 0 0 0 0 0 0 0 0 0 0 0 3 
3 0 3 0 3 0 3 0 3 0 3 0 3 0 3 0 3 
3 0 0 0 0 0 0 0 0 0 0 0 0 0 0 0 3 
3 3 3 3 3 3 3 3 3 3 3 3 3 3 3 3 3 
0 92 954 0 934 114 0 568 297 0 268 478 0 750 599 0 450 782 