3 3 3 3 3 3 3 3 3 3 3 3 3 3 3 3 3 
3 0 0 0 0 0 0 0 0 0 0 0 0 0 0 0 3 
3 0 3 3 3 3 3 0 0 0 3 3 3 3 3 0 3 
3 0 3 3 3 3 0 0 0 0 0 3 3 3 3 0 3 
3 0 3 3 3 0 0 0 0 0 0 0 3 3 3 0 3 
3 0 3 3 0 0 0 0 0 0 0 0 0 3 3 0 3 
3 0 3 0 0 0 0 0 0 0 0 0 0 0 3 0 3 
3 0 0 0 0 0 0 0 0 0 0 0 0 0 0 0 3 
3 0 0 0 0 0 0 0 0 0 0 0 0 0 0 0 3 
3 0 0 0 0 0 0 0 0 0 0 0 0 0 0 0 3 
3 0 3 0 0 0 0 0 0 0 0 0 0 0 3 0 3 
3 0 3 3 0 0 0 0 0 0 0 0 0 3 3 0 3 
3 0 3 3 3 0 0 0 0 0 0 0 3 3 3 0 3 
3 0 3 3 3 3 0 0 0 0 0 3 3 3 3 0 3 
3 0 3 3 3 3 3 0 0 0 3 3 3 3 3 0 3 
3 0 0 0 0 0 0 0 0 0 0 0 0 0 0 0 3 
3 3 3 3 3 3 3 3 3 3 3 3 3 3 3 3 3 
1 328 372 1 672 707 