3 3 3 3 3 3 3 3 3 3 3 3 3 3 3 3 3 
3 0 0 0 0 0 0 0 0 0 0 0 0 0 0 0 3 
3 0 0 0 0 0 0 0 3 0 0 0 0 0 0 0 3 
3 0 0 0 0 0 0 0 3 0 0 0 0 0 0 0 3 
3 0 0 0 0 0 0 0 3 0 0 0 0 0 0 0 3 
3 0 0 0 0 0 0 0 3 0 0 0 0 0 0 0 3 
3 0 0 0 0 0 0 0 3 0 0 0 0 0 0 0 3 
3 0 0 0 0 0 0 0 3 0 0 0 0 0 0 0 3 
3 0 3 3 3 3 3 3 3 3 3 3 3 3 3 0 3 
3 0 0 0 0 0 0 0 3 0 0 0 0 0 0 0 3 
3 0 0 0 0 0 0 0 3 0 0 0 0 0 0 0 3 
3 0 0 0 0 0 0 0 3 0 0 0 0 0 0 0 3 
3 0 0 0 0 0 0 0 3 0 0 0 0 0 0 0 3 
3 0 0 0 0 0 0 0 3 0 0 0 0 0 0 0 3 
3 0 0 0 0 0 0 0 3 0 0 0 0 0 0 0 3 
3 0 0 0 0 0 0 0 0 0 0 0 0 0 0 0 3 
3 3 3 3 3 3 3 3 3 3 3 3 3 3 3 3 3 
0 78 104 0 77 973 0 944 968 0 939 104 0 466 497 0 567 593 