2 2 2 2 2 2 2 2 2 2 2 2 2 2 2 2 2 
2 2 0 0 0 0 0 0 0 0 0 0 0 0 0 2 2 
2 0 2 0 0 0 0 0 0 0 0 0 0 0 2 0 2 
2 0 0 2 0 0 0 0 0 0 0 0 0 2 0 0 2 
2 0 0 0 2 0 0 0 0 0 0 0 2 0 0 0 2 
2 0 0 0 0 2 0 0 0 0 0 2 0 0 0 0 2 
2 0 0 0 0 0 2 0 0 0 2 0 0 0 0 0 2 
2 0 0 0 0 0 0 2 0 2 0 0 0 0 0 0 2 
2 0 0 0 0 0 0 0 0 0 0 0 0 0 0 0 2 
2 0 0 0 0 0 0 2 0 2 0 0 0 0 0 0 2 
2 0 0 0 0 0 2 0 0 0 2 0 0 0 0 0 2 
2 0 0 0 0 2 0 0 0 0 0 2 0 0 0 0 2 
2 0 0 0 2 0 0 0 0 0 0 0 2 0 0 0 2 
2 0 0 2 0 0 0 0 0 0 0 0 0 2 0 0 2 
2 0 2 0 0 0 0 0 0 0 0 0 0 0 2 0 2 
2 2 0 0 0 0 0 0 0 0 0 0 0 0 0 2 2 
2 2 2 2 2 2 2 2 2 2 2 2 2 2 2 2 2 
0 509 299 0 262 539 0 754 549 0 510 783 