3 3 3 3 3 3 3 3 3 3 3 3 3 3 3 3 3 
3 3 0 0 0 0 0 0 0 0 0 0 0 0 0 3 3 
3 0 3 0 0 0 0 0 0 0 0 0 0 0 3 0 3 
3 0 0 3 0 0 0 0 0 0 0 0 0 3 0 0 3 
3 0 0 0 3 0 0 0 0 0 0 0 3 0 0 0 3 
3 0 0 0 0 3 0 0 0 0 0 3 0 0 0 0 3 
3 0 0 0 0 0 3 0 0 0 3 0 0 0 0 0 3 
3 0 0 0 0 0 0 3 0 3 0 0 0 0 0 0 3 
3 0 0 0 0 0 0 0 0 0 0 0 0 0 0 0 3 
3 0 0 0 0 0 0 3 0 3 0 0 0 0 0 0 3 
3 0 0 0 0 0 3 0 0 0 3 0 0 0 0 0 3 
3 0 0 0 0 3 0 0 0 0 0 3 0 0 0 0 3 
3 0 0 0 3 0 0 0 0 0 0 0 3 0 0 0 3 
3 0 0 3 0 0 0 0 0 0 0 0 0 3 0 0 3 
3 0 3 0 0 0 0 0 0 0 0 0 0 0 3 0 3 
3 3 0 0 0 0 0 0 0 0 0 0 0 0 0 3 3 
3 3 3 3 3 3 3 3 3 3 3 3 3 3 3 3 3 
0 270 350 0 699 301 0 735 716 0 322 777 0 507 474 0 453 537 0 568 546 0 509 595 